emma	emma
jose 	jose
alexis	friends
joseph	king
kevin	premier
hailey	sonic
andrew	pizza
savannah	dana
amanda	superstar
madison	cancer
aaron	property
zachary	jumbo
brandon	jean
victoria	random
maria	grateful
kaitlyn	pierce
robert	juhani
james	moore
katherine	bluesky
tyler	techno
brooke	space
dylan	bishop
faith	sidney
michael	huey
abigail	casey
allison	booger
ava		freak1
ella	revolution
jack	fishie
justin	turbo2
lauren	scarecrow
jasmine	scotch
rachel	stinky
isaac	bambi
nicholas	*
jordan	hallo
mia 	miki
isaiah 	ABC123
makayla supra
emily 	enterprise
jason 	adam
elijah 	ferret
christopher 	donkey
benjamin 	bobcat
noah 	marvin
megan 	trees
hannah 	jimi
stephanie 	bluebird
ethan 	glenn
logan 	hitler
alexandra 	erniel
nathan 	lissabon
olivia 	tanner
william	dragon 	
samuel 	whitney
morgan 	lonely
kyle 	carolina
angel 	2200
hunter 	madison
chloe 	clancy
cameron 	tnt
gabriel 	kris
samantha 	business
jacob	hola
joshua 	irene
ashley 	brenda
thomas 	jeffrey1
luke 	snickers
jessica 	spitfire
alexander 	petey
anna	buddha
jonathan	rhino
anthony 	pantera
grace 	bogart
david 	andy
sophia 	perfect
connor	pencil
sydney 	kcin
haley 	spock
destiny	3112
matthew	fun
evan	harley
elizabeth 	iloveyou
taylor	summer
mackenzie	charles
caleb 	corrado
chris 	cruise
john 	sergei
alyssa 	poohbear
ryan 	Lizard
sarah	blood
nicole	sunset
daniel	florida
austin	newyork
julia	active
jennifer 	toronto
isabella	ruby
kayla	coolbean
brianna	coco
natalie	jane